5,5,5,5,5,5,5,5,5,5,5,5,5,5,5,5
5,5,2,5,5,2,5,5,2,5,5,2,5,5,2,5
5,5,2,5,5,2,5,5,2,5,5,2,5,5,2,5
5,1,3,1,1,3,1,1,3,1,1,3,1,1,3,5
5,5,2,5,5,2,5,5,2,5,5,2,5,5,2,5
5,5,2,5,5,2,5,5,2,5,5,2,5,5,2,5
5,1,3,1,1,3,1,1,3,1,1,3,1,1,3,5
5,5,2,5,5,2,5,5,2,5,5,2,5,5,2,5
5,5,2,5,5,2,5,5,2,5,5,2,5,5,2,5
5,5,5,5,5,5,5,5,5,5,5,5,5,5,5,5
