4,4,4,4,4,4,4,4,4,4,4,4,4,4,4,4
4,4,2,4,4,2,4,4,2,4,4,2,4,4,2,4
4,4,2,4,4,2,4,4,2,4,4,2,4,4,2,4
4,1,3,1,1,3,1,1,3,1,1,3,1,1,3,4
4,4,2,4,4,2,4,4,2,4,4,2,4,4,2,4
4,4,2,4,4,2,4,4,2,4,4,2,4,4,2,4
4,1,3,1,1,3,1,1,3,1,1,3,1,1,3,4
4,4,2,4,4,2,4,4,2,4,4,2,4,4,2,4
4,4,2,4,4,2,4,4,2,4,4,2,4,4,2,4
4,4,4,4,4,4,4,4,4,4,4,4,4,4,4,4
