5,5,5,5,5,5,5,5,5,5,5,5,5,5,5,5
5,5,2,5,5,2,5,5,2,5,5,2,5,5,2,5
5,5,2,5,5,2,5,5,2,5,5,2,5,5,2,5
5,1,3,1,1,3,1,1,3,1,1,3,1,1,3,5
5,5,2,5,5,2,5,5,2,5,5,2,5,5,2,5
5,5,2,5,5,2,5,5,2,5,5,2,5,5,2,5
5,1,3,1,1,3,1,1,3,1,1,3,1,1,3,5
5,5,2,5,5,2,5,5,2,5,5,2,5,5,2,5
5,5,2,5,5,2,5,5,2,5,5,8,8,8,8,8
5,1,3,1,1,3,1,1,3,1,1,7,3,3,3,5
5,5,2,5,5,2,5,5,2,5,5,8,3,6,3,8
5,5,2,5,5,2,5,5,2,5,5,8,3,3,3,8
5,5,5,5,5,5,5,5,5,5,5,8,8,8,8,8
